##########
#**  \\\\#
#.R..    #
# \  ..*\#
#!   ..*!#
####   # #
#\\... # L
#\\.W... #
#\\.     #
##########

Growth 10
Razors 1
