######
#. * #
# *\.#
#\ * #
LR .\#
######
