################
#         *   R#
#  *.  *       #
#  *   *.    \\#
#.........    L#
#              #
#.* *. *.*  *  #
#.* *. *.*  *. #
################
