#########
#* *    #
#  * R  #
#....\  #
#       #
#  *.*  #    
#  *.\  #
#...... #
#       #
#       #
#L#######
